"state","district","dem","rep","other","totalvotes","margin","remainingvote"
"Alaska",1,159710,191606,1176,352492,-31896,"1%"
"Alabama",1,116949,211825,0,328774,-94876,"0%"
"Alabama",2,105286,197996,287,303569,-92710,"0%"
"Alabama",3,104595,217384,0,321979,-112789,"0%"
"Alabama",4,56237,261553,0,317790,-205316,"0%"
"Alabama",5,0,253094,0,253094,-253094,"0%"
"Alabama",6,0,274160,8101,282261,-274160,"0%"
"Alabama",7,225742,0,0,225742,225742,"0%"
"Arkansas",1,0,237596,0,237596,-237596,"0%"
"Arkansas",2,148410,184093,0,332503,-35683,"3%"
"Arkansas",3,106325,214960,12977,334262,-108635,"0%"
"Arkansas",4,75750,191617,7668,275035,-115867,"7%"
"Arizona",1,188469,176709,0,365178,11760,"0%"
"Arizona",2,209945,170975,0,380920,38970,"0%"
"Arizona",3,174243,95594,0,269837,78649,"0%"
"Arizona",4,120484,278002,42,398528,-157518,"0%"
"Arizona",5,183171,262414,0,445585,-79243,"0%"
"Arizona",6,199644,217783,0,417427,-18139,"0%"
"Arizona",7,165452,50226,0,215678,115226,"0%"
"Arizona",8,170816,251633,0,422449,-80817,"0%"
"Arizona",9,217094,135180,0,352274,81914,"0%"
"California",1,153857,203641,0,357498,-49784,"0%"
"California",2,293274,93780,0,387054,199494,"2%"
"California",3,171101,140193,0,311294,30908,"0%"
"California",4,194471,246992,0,441463,-52521,"0%"
"California",5,265541,80532,0,346073,185009,"1%"
"California",6,229415,83269,0,312684,146146,"0%"
"California",7,217408,166541,0,383949,50867,"0%"
"California",8,124107,158392,0,282499,-34285,"0%"
"California",9,169695,124554,0,294249,45141,"0%"
"California",10,165325,134220,0,299545,31105,"0%"
"California",11,271027,100267,0,371294,170760,"0%"
"California",12,81062,0,0,362600,81062,"5%"
"California",13,327778,34933,0,362711,292845,"5%"
"California",14,278135,72656,0,350791,205479,"0%"
"California",15,242926,99665,0,342591,143261,"0%"
"California",16,128323,87903,0,216226,40420,"0%"
"California",17,212086,85165,0,297251,126921,"0%"
"California",18,126692,0,0,344002,126692,"10%"
"California",19,224305,88609,0,312914,135696,"0%"
"California",20,236581,71579,0,308160,165002,"0%"
"California",21,83619,85373,0,168992,-1754,"0%"
"California",22,143921,170504,0,314425,-26583,"0%"
"California",23,115281,189184,0,304465,-73903,"0%"
"California",24,212563,149780,0,362343,62783,"0%"
"California",25,169059,169464,0,338523,-405,"0%"
"California",26,208793,135829,0,344622,72964,"0%"
"California",27,221206,95817,0,317023,125389,"0%"
"California",28,244078,91836,0,335914,152242,"0%"
"California",29,91448,0,0,210749,91448,"0%"
"California",30,239829,105314,0,345143,134515,"0%"
"California",31,174796,110483,0,285279,64313,"0%"
"California",32,172794,86738,0,259532,86056,"0%"
"California",33,256854,123230,0,380084,133624,"6%"
"California",34,96461,0,0,205163,96461,"0%"
"California",35,168946,74744,0,243690,94202,"0%"
"California",36,184900,121519,0,306419,63381,"0%"
"California",37,254698,41657,0,296355,213041,"6%"
"California",38,65694,0,0,256007,65694,"3%"
"California",39,169731,173857,0,343588,-4126,"0%"
"California",40,135445,50758,0,186203,84687,"1%"
"California",41,167764,94202,0,261966,73562,"0%"
"California",42,157550,209926,0,367476,-52376,"0%"
"California",43,199036,78616,0,277652,120420,"0%"
"California",44,66303,0,0,205827,66303,"2%"
"California",45,221843,193096,0,414939,28747,"0%"
"California",46,157803,71716,0,229519,86087,"0%"
"California",47,196934,114323,0,311257,82611,"0%"
"California",48,193362,201738,0,395100,-8376,"0%"
"California",49,205179,181027,0,386206,24152,"0%"
"California",50,166786,195427,0,362213,-28641,"0%"
"California",51,165272,76527,0,241799,88745,"0%"
"California",52,244175,152323,0,396498,91852,"0%"
"California",53,135561,0,0,334740,135561,"5%"
"Colorado",1,331624,105955,12714,450293,225669,"5%"
"Colorado",2,316925,182547,16191,515663,134378,"7%"
"Colorado",3,193983,220508,14538,429029,-26525,"4%"
"Colorado",4,173945,285606,15556,475107,-111661,"0%"
"Colorado",5,161600,249013,21794,432407,-87413,"2%"
"Colorado",6,250366,175227,12969,438562,75139,"2%"
"Colorado",7,250525,159301,13865,423691,91224,"4%"
"Connecticut",1,224442,122088,4506,351036,102354,"5%"
"Connecticut",2,217982,140409,8854,367245,77573,"4%"
"Connecticut",3,238859,144577,6082,389518,94282,"0%"
"Connecticut",4,225598,130635,5658,361891,94963,"2%"
"Connecticut",5,192543,152003,5052,349598,40540,"3%"
"Delaware",1,281382,196392,10496,488270,84990,"0%"
"Florida",1,149172,283352,6038,438562,-134180,"0%"
"Florida",2,0,305337,6662,311999,-305337,"0%"
"Florida",3,167326,223075,0,390401,-55749,"0%"
"Florida",4,196423,308497,20,504940,-112074,"0%"
"Florida",5,219463,117510,0,336973,101953,"0%"
"Florida",6,172305,265393,158,437856,-93088,"0%"
"Florida",7,224946,175750,5753,406449,49196,"0%"
"Florida",8,177695,282093,0,459788,-104398,"0%"
"Florida",9,240724,188889,25,429638,51835,"0%"
"Florida",10,239434,136889,74,376397,102545,"0%"
"Florida",11,158094,316979,0,475073,-158885,"0%"
"Florida",12,168194,284941,0,453135,-116747,"0%"
"Florida",13,215405,190713,7,406125,24692,"0%"
"Florida",14,224240,147896,0,372136,76344,"0%"
"Florida",15,174297,216374,0,390671,-42077,"0%"
"Florida",16,215683,269001,0,484684,-53318,"0%"
"Florida",17,140487,266514,5396,412397,-126027,"0%"
"Florida",18,186674,253286,9760,449720,-66612,"0%"
"Florida",19,172146,272440,3,444589,-100294,"0%"
"Florida",20,253661,68748,0,322409,184913,"0%"
"Florida",21,237925,157612,7750,403287,80313,"0%"
"Florida",22,235764,166553,0,402317,69211,"0%"
"Florida",23,221239,158874,83,380196,62365,"0%"
"Florida",24,218825,59084,11729,289638,159741,"0%"
"Florida",25,0,0,0,0,0,"NA%"
"Florida",26,165407,177223,0,342630,-11816,"0%"
"Florida",27,166758,176141,76,342975,-9383,"0%"
"Georgia",1,135238,189457,0,324695,-54219,"0%"
"Georgia",2,161397,111620,0,273017,49777,"0%"
"Georgia",3,129792,241526,18,371336,-111734,"0%"
"Georgia",4,278906,69393,0,348299,209513,"0%"
"Georgia",5,301857,52646,0,354503,249211,"0%"
"Georgia",6,216775,180329,0,397104,36446,"0%"
"Georgia",7,190900,180564,0,371464,10336,"0%"
"Georgia",8,109264,198701,24,307989,-89437,"0%"
"Georgia",9,79797,292750,3,372550,-212953,"0%"
"Georgia",10,142636,235810,60,378506,-93174,"0%"
"Georgia",11,160623,245259,0,405882,-84636,"0%"
"Georgia",12,129061,181038,0,310099,-51977,"0%"
"Georgia",13,279045,81476,0,360521,197569,"0%"
"Georgia",14,77798,229827,323,307948,-152029,"0%"
"Hawaii",1,183245,71188,0,254433,112057,"0%"
"Hawaii",2,171517,84027,16558,272102,87490,"0%"
"Iowa",1,201347,212088,0,413435,-10741,"9%"
"Iowa",2,196849,196886,0,393735,-37,"11%"
"Iowa",3,219205,212997,15361,447563,6208,"4%"
"Iowa",4,144761,237369,0,382130,-92608,"13%"
"Idaho",1,131380,310736,16453,458569,-179356,"0%"
"Idaho",2,124151,250668,16513,391332,-126517,"0%"
"Illinois",1,239931,84918,0,324849,155013,"11%"
"Illinois",2,234738,62997,0,297735,171741,"12%"
"Illinois",3,172997,133851,0,306848,39146,"4%"
"Illinois",4,187219,35518,0,222737,151701,"6%"
"Illinois",5,255661,96200,9408,361269,159461,"1%"
"Illinois",6,213351,183583,7067,404001,29768,"0%"
"Illinois",7,249383,41390,19355,310128,207993,"11%"
"Illinois",8,186251,0,68327,254578,186251,"0%"
"Illinois",9,262045,107125,0,369170,154920,"3%"
"Illinois",10,198969,113104,0,312073,85865,"3%"
"Illinois",11,194557,112807,0,307364,81750,"2%"
"Illinois",12,125511,192807,0,318318,-67296,"10%"
"Illinois",13,150316,180176,0,330492,-29860,"9%"
"Illinois",14,202663,197493,0,400156,5170,"0%"
"Illinois",15,91405,230955,0,322360,-139550,"10%"
"Illinois",16,117904,217149,168,335221,-99245,"4%"
"Illinois",17,154441,142881,0,297322,11560,"9%"
"Illinois",18,107951,258093,0,366044,-150142,"6%"
"Indiana",1,185180,132247,9521,326948,52933,"0%"
"Indiana",2,114967,183601,0,298568,-68634,"0%"
"Indiana",3,104762,220989,0,325751,-116227,"0%"
"Indiana",4,112984,225531,0,338515,-112547,"0%"
"Indiana",5,191226,208212,16788,416226,-16986,"0%"
"Indiana",6,91103,225318,11791,328212,-134215,"0%"
"Indiana",7,176422,106146,0,282568,70276,"0%"
"Indiana",8,95691,214643,10283,320617,-118952,"0%"
"Indiana",9,122564,222054,14415,359033,-99490,"0%"
"Kansas",1,81561,204275,0,285836,-122714,"3%"
"Kansas",2,133354,182145,13754,329253,-48791,"1%"
"Kansas",3,212604,174163,11119,397886,38441,"0%"
"Kansas",4,110922,197433,0,308355,-86511,"0%"
"Kentucky",1,82141,246329,0,328470,-164188,"0%"
"Kentucky",2,94643,255735,10021,360399,-161092,"0%"
"Kentucky",3,230672,137425,0,368097,93247,"0%"
"Kentucky",4,125896,256613,0,382509,-130717,"0%"
"Kentucky",5,47056,250914,7,297977,-203858,"0%"
"Kentucky",6,155011,216948,6491,378450,-61937,"0%"
"Louisiana",1,94730,270330,9309,374369,-175600,"0%"
"Louisiana",2,33684,15565,18522,316982,18119,"0%"
"Louisiana",3,39423,230480,9365,340120,-191057,"0%"
"Louisiana",4,23813,19343,0,306578,4470,"0%"
"Louisiana",5,7136,9834,0,309556,-2698,"0%"
"Louisiana",6,95541,265706,12749,373996,-170165,"0%"
"Massachusetts",1,275376,0,9956,285332,275376,"0%"
"Massachusetts",2,252304,127281,551,380136,125023,"1%"
"Massachusetts",3,245840,0,7462,253302,245840,"14%"
"Massachusetts",4,214977,147243,1690,363910,67734,"12%"
"Massachusetts",5,275104,96783,1783,373670,178321,"6%"
"Massachusetts",6,265720,138621,674,405015,127099,"7%"
"Massachusetts",7,128137,0,22067,150204,128137,"50%"
"Massachusetts",8,248611,0,62586,311197,248611,"19%"
"Massachusetts",9,256158,152416,10535,419109,103742,"1%"
"Maryland",1,143877,250901,0,394778,-107024,"4%"
"Maryland",2,224836,106355,0,331191,118481,"6%"
"Maryland",3,260358,112117,0,372475,148241,"3%"
"Maryland",4,282119,71671,0,353790,210448,"3%"
"Maryland",5,274210,123525,0,397735,150685,"3%"
"Maryland",6,215540,143599,6893,366032,71941,"3%"
"Maryland",7,237084,92825,74,329983,144259,"8%"
"Maryland",8,274716,127157,0,401873,147559,"2%"
"Maine",1,211905,139529,800,352234,72376,"22%"
"Maine",2,174734,150407,1331,326472,24327,"20%"
"Michigan",1,153328,256581,6310,416219,-103253,"3%"
"Michigan",2,154122,238711,10414,403247,-84589,"1%"
"Michigan",3,189769,213649,0,403418,-23880,"3%"
"Michigan",4,120802,242621,9822,373245,-121819,"4%"
"Michigan",5,196599,150772,13661,361032,45827,"6%"
"Michigan",6,152085,211496,14839,378420,-59411,"4%"
"Michigan",7,159743,227524,0,387267,-67781,"4%"
"Michigan",8,217922,202525,7897,428344,15397,"2%"
"Michigan",9,230318,153296,15502,399116,77022,"5%"
"Michigan",10,138179,271607,0,409786,-133428,"3%"
"Michigan",11,226128,215405,8936,450469,10723,"3%"
"Michigan",12,254957,117719,11147,383823,137238,"4%"
"Michigan",13,223205,53311,9363,285879,169894,"9%"
"Michigan",14,271370,62664,8269,342303,208706,"9%"
"Minnesota",1,167890,179234,21448,368572,-11344,"0%"
"Minnesota",2,204534,194954,24751,424239,9580,"0%"
"Minnesota",3,246666,196625,0,443291,50041,"0%"
"Minnesota",4,245813,112730,29537,388080,133083,"0%"
"Minnesota",5,255924,102878,37979,396781,153046,"0%"
"Minnesota",6,140853,270901,0,411754,-130048,"0%"
"Minnesota",7,144840,194065,24209,363114,-49225,"0%"
"Minnesota",8,147853,223432,22190,393475,-75579,"0%"
"Missouri",1,249087,59940,6766,315793,189147,"10%"
"Missouri",2,204468,233094,11714,449276,-28626,"4%"
"Missouri",3,116109,282424,8328,406861,-166315,"2%"
"Missouri",4,107582,245109,9945,362636,-137527,"3%"
"Missouri",5,206209,135910,9271,351390,70299,"3%"
"Missouri",6,120876,259030,8157,388063,-138154,"0%"
"Missouri",7,98059,254366,15565,367990,-156307,"0%"
"Missouri",8,70504,253646,5846,329996,-183142,"6%"
"Mississippi",1,103994,228731,280,333005,-124737,"3%"
"Mississippi",2,196331,101037,203,297571,95294,"7%"
"Mississippi",3,119880,220547,0,340427,-100667,"5%"
"Mississippi",4,0,255960,8670,264630,-255960,"7%"
"Montana",1,262340,339169,0,601509,-76829,"0%"
"North Carolina",1,188870,159748,0,348618,29122,"0%"
"North Carolina",2,311887,172544,10914,495345,139343,"0%"
"North Carolina",3,132752,229800,0,362552,-97048,"0%"
"North Carolina",4,332421,161298,0,493719,171123,"0%"
"North Carolina",5,119846,257843,7555,385244,-137997,"0%"
"North Carolina",6,253531,153598,0,407129,99933,"0%"
"North Carolina",7,179045,272443,0,451488,-93398,"0%"
"North Carolina",8,177781,202774,0,380555,-24993,"0%"
"North Carolina",9,179463,224661,0,404124,-45198,"0%"
"North Carolina",10,128189,284095,0,412284,-155906,"0%"
"North Carolina",11,190609,245351,14185,450145,-54742,"0%"
"North Carolina",12,341457,0,0,341457,341457,"0%"
"North Carolina",13,124684,267181,0,391865,-142497,"0%"
"North Dakota",1,97970,245229,12024,355223,-147259,"0%"
"Nebraska",1,119622,189006,8938,317566,-69384,"0%"
"Nebraska",2,155706,171071,10185,336962,-15365,"0%"
"Nebraska",3,50699,225194,10931,286824,-174495,"4%"
"New Hampshire",1,205606,185159,9830,400595,20447,"0%"
"New Hampshire",2,208289,168886,9172,386347,39403,"0%"
"New Jersey",1,225041,135835,0,360876,89206,"4%"
"New Jersey",2,163065,183035,6337,352437,-19970,"6%"
"New Jersey",3,227555,192797,5452,425804,34758,"0%"
"New Jersey",4,161462,250260,7767,419489,-88798,"0%"
"New Jersey",5,225043,193167,5125,423335,31876,"0%"
"New Jersey",6,199645,126756,0,326401,72889,"1%"
"New Jersey",7,219629,214315,0,433944,5314,"0%"
"New Jersey",8,144049,42965,2368,189382,101084,"28%"
"New Jersey",9,201135,96653,7067,304855,104482,"4%"
"New Jersey",10,228055,35740,7313,271108,192315,"13%"
"New Jersey",11,235135,205970,0,441105,29165,"0%"
"New Jersey",12,230883,114591,6251,351725,116292,"2%"
"New Mexico",1,186953,134337,0,321290,52616,"0%"
"New Mexico",2,122546,142283,117,264946,-19737,"0%"
"New Mexico",3,186282,131166,0,317448,55116,"0%"
"Nevada",1,137868,74490,10855,223213,63378,"0%"
"Nevada",2,155780,216078,10815,382673,-60298,"0%"
"Nevada",3,203421,190975,22856,417252,12446,"0%"
"Nevada",4,168457,152284,11728,332469,16173,"0%"
"New York",1,111203,176323,65,287591,-65120,"23%"
"New York",2,124153,164367,2802,291322,-40214,"16%"
"New York",3,172120,149692,1914,323726,22428,"15%"
"New York",4,199012,152573,3129,354714,46439,"4%"
"New York",5,187590,0,113,187703,187590,"30%"
"New York",6,106131,63324,0,169455,42807,"26%"
"New York",7,142815,27907,1158,171880,114908,"24%"
"New York",8,175140,36873,0,212013,138267,"25%"
"New York",9,170898,36847,1947,209692,134051,"25%"
"New York",10,120273,52842,2156,175271,67431,"39%"
"New York",11,99224,136382,0,235606,-37158,"15%"
"New York",12,153815,37973,2732,194520,115842,"42%"
"New York",13,179589,16787,2747,199123,162802,"28%"
"New York",14,105455,46877,1042,153374,58578,"29%"
"New York",15,136471,18198,0,154669,118273,"26%"
"New York",16,161730,0,33608,195338,161730,"37%"
"New York",17,159014,108373,16975,284362,50641,"19%"
"New York",18,143488,131095,2576,277159,12393,"19%"
"New York",19,160160,140756,7948,308864,19404,"13%"
"New York",20,218008,138664,189,356861,79344,"0%"
"New York",21,114643,178840,97,293580,-64197,"6%"
"New York",22,140656,149779,6551,296986,-9123,"8%"
"New York",23,105331,170079,3274,278684,-64748,"13%"
"New York",24,122763,181084,11718,315565,-58321,"8%"
"New York",25,206396,136198,5504,348098,70198,"4%"
"New York",26,174201,83276,3637,261114,90925,"22%"
"New York",27,126649,216148,4547,347344,-89499,"10%"
"Ohio",1,172022,199560,13703,385285,-27538,"0%"
"Ohio",2,146781,230430,37,377248,-83649,"0%"
"Ohio",3,227420,93569,103,321092,133851,"0%"
"Ohio",4,101897,235875,9854,347626,-133978,"0%"
"Ohio",5,120959,257019,0,377978,-136060,"0%"
"Ohio",6,85661,249130,0,334791,-163469,"0%"
"Ohio",7,102271,236607,11671,350549,-134336,"0%"
"Ohio",8,110766,246277,114,357157,-135511,"0%"
"Ohio",9,190328,111385,39,301752,78943,"0%"
"Ohio",10,151976,212972,0,364948,-60996,"0%"
"Ohio",11,242098,60323,0,302421,181775,"0%"
"Ohio",12,182847,241790,13035,437672,-58943,"0%"
"Ohio",13,173631,148648,8522,330801,24983,"0%"
"Ohio",14,158586,238864,0,397450,-80278,"0%"
"Ohio",15,140183,243103,75,383361,-102920,"0%"
"Ohio",16,144071,247335,0,391406,-103264,"0%"
"Oklahoma",1,109641,213700,12130,335471,-104059,"0%"
"Oklahoma",2,63472,216511,8544,288527,-153039,"0%"
"Oklahoma",3,66501,242677,0,309178,-176176,"0%"
"Oklahoma",4,90459,213096,10803,314358,-122637,"0%"
"Oklahoma",5,145658,158191,0,303849,-12533,"0%"
"Oregon",1,297071,161928,0,458999,135143,"0%"
"Oregon",2,168881,273835,14094,456810,-104954,"0%"
"Oregon",3,343574,110570,15741,469885,233004,"0%"
"Oregon",4,240950,216081,10118,467149,24869,"0%"
"Oregon",5,234824,204298,12630,451752,30526,"0%"
"Pennsylvania",1,191875,249804,0,441679,-57929,"2%"
"Pennsylvania",2,198268,75083,0,273351,123185,"17%"
"Pennsylvania",3,341922,33728,0,375650,308194,"13%"
"Pennsylvania",4,264638,179926,0,444564,84712,"0%"
"Pennsylvania",5,256021,139686,0,395707,116335,"7%"
"Pennsylvania",6,226440,177526,0,403966,48914,"1%"
"Pennsylvania",7,197907,181744,0,379651,16163,"2%"
"Pennsylvania",8,178442,166229,0,344671,12213,"5%"
"Pennsylvania",9,118315,233076,0,351391,-114761,"4%"
"Pennsylvania",10,182938,208896,0,391834,-25958,"3%"
"Pennsylvania",11,141325,241915,0,383240,-100590,"1%"
"Pennsylvania",12,99073,240751,0,339824,-141678,"5%"
"Pennsylvania",13,96717,267908,0,364625,-171191,"2%"
"Pennsylvania",14,131885,241724,0,373609,-109839,"3%"
"Pennsylvania",15,92150,255060,0,347210,-162910,"3%"
"Pennsylvania",16,143904,210068,0,353972,-66164,"6%"
"Pennsylvania",17,222242,212279,0,434521,9963,"3%"
"Pennsylvania",18,266084,118163,0,384247,147921,"9%"
"Rhode Island",1,158550,0,63757,222307,158550,"8%"
"Rhode Island",2,154086,109894,0,263980,44192,"2%"
"South Carolina",1,210627,216042,0,426669,-5415,"0%"
"South Carolina",2,155118,202715,6163,363996,-47597,"0%"
"South Carolina",3,95712,237544,0,333256,-141832,"0%"
"South Carolina",4,133023,222126,5090,360239,-89103,"0%"
"South Carolina",5,145958,220005,0,365963,-74047,"0%"
"South Carolina",6,197477,89258,2646,289381,108219,"0%"
"South Carolina",7,138863,224993,0,363856,-86130,"0%"
"South Dakota",1,0,321984,75748,397732,-321984,"0%"
"Tennessee",1,68211,227838,8602,304651,-159627,"1%"
"Tennessee",2,109298,238447,4574,352319,-129149,"0%"
"Tennessee",3,97510,215318,7022,319850,-117808,"0%"
"Tennessee",4,111238,223200,0,334438,-111962,"0%"
"Tennessee",5,250001,0,0,250001,250001,"10%"
"Tennessee",6,83694,257219,8139,349052,-173525,"0%"
"Tennessee",7,95743,244623,9586,349952,-148880,"0%"
"Tennessee",8,97561,226949,6741,331251,-129388,"4%"
"Tennessee",9,187258,48688,6136,242082,138570,"6%"
"Texas",1,83016,219726,0,302742,-136710,"0%"
"Texas",2,148374,192828,5524,346726,-44454,"0%"
"Texas",3,179458,230512,8621,418591,-51054,"0%"
"Texas",4,76326,253837,7640,337803,-177511,"0%"
"Texas",5,100743,173836,5834,280413,-73093,"0%"
"Texas",6,149530,179507,10955,339992,-29977,"0%"
"Texas",7,159529,149054,5542,314125,10475,"0%"
"Texas",8,97409,277327,7735,382471,-179918,"0%"
"Texas",9,172938,49575,6594,229107,123363,"0%"
"Texas",10,187686,217216,8992,413894,-29530,"0%"
"Texas",11,53394,232568,5811,291773,-179174,"0%"
"Texas",12,121250,233853,11918,367021,-112603,"0%"
"Texas",13,50477,217124,5907,273508,-166647,"0%"
"Texas",14,118574,190541,0,309115,-71967,"0%"
"Texas",15,115605,109017,4295,228917,6588,"0%"
"Texas",16,154108,84006,0,238114,70102,"0%"
"Texas",17,125565,171390,9918,306873,-45825,"0%"
"Texas",18,180952,58033,7910,246895,122919,"0%"
"Texas",19,60583,198198,6271,265052,-137615,"0%"
"Texas",20,175078,89628,6017,270723,85450,"0%"
"Texas",21,205780,235740,8666,450186,-29960,"0%"
"Texas",22,181998,210259,15791,408048,-28261,"0%"
"Texas",23,137693,149395,8369,295457,-11702,"0%"
"Texas",24,163326,167910,12785,344021,-4584,"0%"
"Texas",25,165697,220088,7738,393523,-54391,"0%"
"Texas",26,161009,261963,9243,432215,-100954,"0%"
"Texas",27,95466,172305,5482,273253,-76839,"0%"
"Texas",28,137494,91925,6425,235844,45569,"0%"
"Texas",29,111305,42840,2328,156473,68465,"0%"
"Texas",30,204928,48685,10851,264464,156243,"0%"
"Texas",31,176293,212695,9099,398087,-36402,"0%"
"Texas",32,178542,157867,7278,343687,20675,"0%"
"Texas",33,105317,39638,12651,157606,65679,"0%"
"Texas",34,111439,84119,5469,201027,27320,"0%"
"Texas",35,176373,80795,12629,269797,95578,"0%"
"Texas",36,73418,222712,6419,302549,-149294,"0%"
"Utah",1,104194,237988,169,342351,-133794,"0%"
"Utah",2,129762,208997,15465,354224,-79235,"0%"
"Utah",3,96067,246674,16186,358927,-150607,"0%"
"Utah",4,175923,179688,21119,376730,-3765,"0%"
"Virginia",1,186923,260614,0,447537,-73691,"0%"
"Virginia",2,185733,165031,9170,359934,20702,"1%"
"Virginia",3,233326,107299,0,340625,126027,"0%"
"Virginia",4,241142,149625,0,390767,91517,"0%"
"Virginia",5,190315,210988,0,401303,-20673,"0%"
"Virginia",6,134729,246606,0,381335,-111877,"0%"
"Virginia",7,230893,222623,0,453516,8270,"0%"
"Virginia",8,301454,95365,0,396819,206089,"0%"
"Virginia",9,0,271851,0,271851,-271851,"0%"
"Virginia",10,268734,206253,0,474987,62481,"0%"
"Virginia",11,280725,111380,0,392105,169345,"0%"
"Vermont",1,238827,95830,20182,354839,142997,"0%"
"Washington",1,249656,176054,0,425710,73602,"0%"
"Washington",2,255252,148384,0,403636,106868,"0%"
"Washington",3,181347,235579,0,416926,-54232,"0%"
"Washington",4,102549,201923,0,304472,-99374,"0%"
"Washington",5,155737,247815,0,403552,-92078,"0%"
"Washington",6,247429,168783,0,416212,78646,"0%"
"Washington",7,387109,78240,0,465349,308869,"2%"
"Washington",8,212961,198360,41,411362,14601,"0%"
"Washington",9,258771,89697,0,348468,169074,"0%"
"Washington",10,120644,0,1157,289268,120644,"14%"
"Wisconsin",1,163170,238271,0,401441,-75101,"0%"
"Wisconsin",2,318523,138306,0,456829,180217,"0%"
"Wisconsin",3,199885,189619,0,389504,10266,"0%"
"Wisconsin",4,232668,70769,7911,311348,161899,"0%"
"Wisconsin",5,175902,265434,0,441336,-89532,"0%"
"Wisconsin",6,164239,238874,220,403333,-74635,"0%"
"Wisconsin",7,162741,252046,0,414787,-89305,"0%"
"Wisconsin",8,149558,268173,0,417731,-118615,"0%"
"West Virginia",1,81177,180488,17,261682,-99311,"3%"
"West Virginia",2,100799,172195,0,272994,-71396,"1%"
"West Virginia",3,64898,161501,27,226426,-96603,"6%"
"Wyoming",1,66576,185732,18059,270367,-119156,"0%"
