"state","district","dem","rep","other","totalvotes","margin","remainingvote"
"Alaska",1,156754,188154,0,344908,-31400,"1%"
"Alabama",1,96363,204399,0,300762,-108036,"12%"
"Alabama",2,104592,197329,286,302207,-92737,"6%"
"Alabama",3,103051,214731,0,317782,-111680,"2%"
"Alabama",4,50730,246668,0,297398,-195938,"9%"
"Alabama",5,0,251896,0,251896,-251896,"1%"
"Alabama",6,0,273205,8062,281267,-273205,"1%"
"Alabama",7,224995,0,0,224995,224995,"1%"
"Arkansas",1,0,237214,0,237214,-237214,"1%"
"Arkansas",2,145377,182494,0,327871,-37117,"5%"
"Arkansas",3,106305,214918,12976,334199,-108613,"1%"
"Arkansas",4,75889,194047,7769,277705,-118158,"7%"
"Arizona",1,187860,175267,0,363127,12593,"1%"
"Arizona",2,209945,170975,0,380920,38970,"3%"
"Arizona",3,174243,95594,0,269837,78649,"1%"
"Arizona",4,119430,274686,42,394158,-155256,"1%"
"Arizona",5,183171,262414,0,445585,-79243,"1%"
"Arizona",6,199644,217783,0,417427,-18139,"1%"
"Arizona",7,165452,50226,0,215678,115226,"1%"
"Arizona",8,170816,251633,0,422449,-80817,"1%"
"Arizona",9,217094,135180,0,352274,81914,"1%"
"California",1,149986,197556,0,347542,-47570,"3%"
"California",2,272830,82433,0,355263,190397,"10%"
"California",3,158012,127180,0,285192,30832,"5%"
"California",4,187355,236151,0,423506,-48796,"1%"
"California",5,259935,78261,0,338196,181674,"3%"
"California",6,204273,71861,0,276134,132412,"1%"
"California",7,201912,153314,0,355226,48598,"1%"
"California",8,118672,151766,0,270438,-33094,"1%"
"California",9,150477,108180,0,258657,42297,"5%"
"California",10,156365,125993,0,282358,30372,"1%"
"California",11,266074,97913,0,363987,168161,"1%"
"California",12,80495,0,0,360628,80495,"5%"
"California",13,327278,34850,0,362128,292428,"5%"
"California",14,275628,71996,0,347624,203632,"1%"
"California",15,241808,99067,0,340875,142741,"1%"
"California",16,126299,86669,0,212968,39630,"1%"
"California",17,210889,84673,0,295562,126216,"1%"
"California",18,125610,0,0,341359,125610,"11%"
"California",19,212908,83786,0,296694,129122,"1%"
"California",20,232379,69946,0,302325,162433,"1%"
"California",21,79092,81157,0,160249,-2065,"1%"
"California",22,142569,168912,0,311481,-26343,"1%"
"California",23,109450,175572,0,285022,-66122,"1%"
"California",24,207844,145918,0,353762,61926,"1%"
"California",25,166513,166617,0,333130,-104,"1%"
"California",26,207543,134798,0,342341,72745,"1%"
"California",27,214718,98452,0,313170,116266,"1%"
"California",28,240931,90113,0,331044,150818,"1%"
"California",29,89849,0,0,207449,89849,"1%"
"California",30,237153,103555,0,340708,133598,"2%"
"California",31,167481,106006,0,273487,61475,"1%"
"California",32,170359,85496,0,255855,84863,"1%"
"California",33,254005,121405,0,375410,132600,"7%"
"California",34,94761,0,0,201805,94761,"1%"
"California",35,161931,71656,0,233587,90275,"1%"
"California",36,159760,103384,0,263144,56376,"3%"
"California",37,251496,40774,0,292270,210722,"7%"
"California",38,64759,0,0,252385,64759,"4%"
"California",39,165815,169973,0,335788,-4158,"1%"
"California",40,133368,49607,0,182975,83761,"3%"
"California",41,149119,83894,0,233013,65225,"1%"
"California",42,139604,184886,0,324490,-45282,"1%"
"California",43,196375,77465,0,273840,118910,"1%"
"California",44,64899,0,0,202595,64899,"4%"
"California",45,217129,188848,0,405977,28281,"1%"
"California",46,152858,69363,0,222221,83495,"1%"
"California",47,193822,111731,0,305553,82091,"1%"
"California",48,191341,199133,0,390474,-7792,"1%"
"California",49,203973,179358,0,383331,24615,"1%"
"California",50,163204,191312,0,354516,-28108,"1%"
"California",51,160211,73135,0,233346,87076,"1%"
"California",52,243697,151995,0,395692,91702,"1%"
"California",53,135251,0,0,334032,135251,"6%"
"Colorado",1,331624,105954,12714,450292,225670,"5%"
"Colorado",2,316916,182539,16189,515644,134377,"7%"
"Colorado",3,193980,220502,14536,429018,-26522,"4%"
"Colorado",4,173940,285594,15555,475089,-111654,"1%"
"Colorado",5,161399,248829,21757,431985,-87430,"2%"
"Colorado",6,250366,175227,12969,438562,75139,"2%"
"Colorado",7,250524,159301,13865,423690,91223,"4%"
"Connecticut",1,224442,122088,4506,351036,102354,"5%"
"Connecticut",2,217982,140409,8854,367245,77573,"4%"
"Connecticut",3,238717,144486,6077,389280,94231,"1%"
"Connecticut",4,225598,130635,5658,361891,94963,"2%"
"Connecticut",5,192543,152003,5052,349598,40540,"3%"
"Delaware",1,281382,196392,10496,488270,84990,"1%"
"Florida",1,149172,283352,6038,438562,-134180,"6%"
"Florida",2,0,305337,6662,311999,-305337,"8%"
"Florida",3,167326,223075,0,390401,-55749,"10%"
"Florida",4,196423,308497,20,504940,-112074,"3%"
"Florida",5,219463,117510,0,336973,101953,"12%"
"Florida",6,172305,265393,158,437856,-93088,"6%"
"Florida",7,224946,175750,5753,406449,49196,"9%"
"Florida",8,177680,282279,0,459959,-104599,"7%"
"Florida",9,240724,188889,19,429632,51835,"2%"
"Florida",10,239434,136889,0,376323,102545,"1%"
"Florida",11,158094,316979,0,475073,-158885,"6%"
"Florida",12,168194,284941,0,453135,-116747,"3%"
"Florida",13,215405,190713,7,406125,24692,"9%"
"Florida",14,224240,147896,0,372136,76344,"9%"
"Florida",15,174383,216372,0,390755,-41989,"6%"
"Florida",16,215454,268772,0,484226,-53318,"2%"
"Florida",17,140487,266514,5396,412397,-126027,"5%"
"Florida",18,186674,253286,9760,449720,-66612,"5%"
"Florida",19,172146,272440,0,444586,-100294,"1%"
"Florida",20,253661,68748,0,322409,184913,"9%"
"Florida",21,237925,157612,7544,403081,80313,"1%"
"Florida",22,235764,166553,0,402317,69211,"8%"
"Florida",23,221239,158874,83,380196,62365,"8%"
"Florida",24,218825,59084,11729,289638,159741,"1%"
"Florida",25,0,0,0,0,0,"NA%"
"Florida",26,165407,177223,0,342630,-11816,"1%"
"Florida",27,166758,176141,76,342975,-9383,"7%"
"Georgia",1,135383,189579,0,324962,-54196,"6%"
"Georgia",2,161398,111615,0,273013,49783,"14%"
"Georgia",3,129054,240134,18,369206,-111080,"8%"
"Georgia",4,278823,69386,0,348209,209437,"9%"
"Georgia",5,301854,52646,0,354500,249208,"10%"
"Georgia",6,216775,180329,0,397104,36446,"7%"
"Georgia",7,190900,180564,0,371464,10336,"3%"
"Georgia",8,109263,198698,24,307985,-89435,"9%"
"Georgia",9,79797,292747,3,372547,-212950,"2%"
"Georgia",10,142598,235580,60,378238,-92982,"6%"
"Georgia",11,160623,245259,0,405882,-84636,"4%"
"Georgia",12,129061,181039,0,310100,-51978,"10%"
"Georgia",13,278552,81154,0,359706,197398,"7%"
"Georgia",14,76860,227885,323,305068,-151025,"1%"
"Hawaii",1,183245,71188,0,254433,112057,"2%"
"Hawaii",2,171454,83987,16542,271983,87467,"1%"
"Iowa",1,201347,212088,0,413435,-10741,"9%"
"Iowa",2,196812,196860,0,393672,-48,"11%"
"Iowa",3,219205,212997,15361,447563,6208,"4%"
"Iowa",4,144722,237319,0,382041,-92597,"13%"
"Idaho",1,126995,299792,15918,442705,-172797,"1%"
"Idaho",2,118955,232563,15147,366665,-113608,"1%"
"Illinois",1,231568,83566,0,315134,148002,"14%"
"Illinois",2,226946,62305,0,289251,164641,"15%"
"Illinois",3,164943,130635,0,295578,34308,"8%"
"Illinois",4,182084,34723,0,216807,147361,"8%"
"Illinois",5,248158,94301,9029,351488,153857,"4%"
"Illinois",6,211502,182316,7002,400820,29186,"1%"
"Illinois",7,244014,40755,18927,303696,203259,"13%"
"Illinois",8,182712,0,67382,250094,182712,"2%"
"Illinois",9,251947,104390,0,356337,147557,"6%"
"Illinois",10,197216,112291,0,309507,84925,"4%"
"Illinois",11,192967,112011,0,304978,80956,"3%"
"Illinois",12,125511,192807,0,318318,-67296,"10%"
"Illinois",13,150316,180176,0,330492,-29860,"9%"
"Illinois",14,200638,196034,0,396672,4604,"1%"
"Illinois",15,91405,230955,0,322360,-139550,"10%"
"Illinois",16,115354,214558,168,330080,-99204,"6%"
"Illinois",17,154010,142636,0,296646,11374,"9%"
"Illinois",18,107937,258047,0,365984,-150110,"6%"
"Indiana",1,185176,132243,9521,326940,52933,"3%"
"Indiana",2,114963,183600,0,298563,-68637,"3%"
"Indiana",3,104762,220989,0,325751,-116227,"1%"
"Indiana",4,112984,225531,0,338515,-112547,"1%"
"Indiana",5,191226,208212,16788,416226,-16986,"1%"
"Indiana",6,90963,225221,11784,327968,-134258,"3%"
"Indiana",7,176422,106146,0,282568,70276,"5%"
"Indiana",8,95691,214643,10283,320617,-118952,"5%"
"Indiana",9,122543,222022,14410,358975,-99479,"1%"
"Kansas",1,81561,204275,0,285836,-122714,"3%"
"Kansas",2,133354,182145,13754,329253,-48791,"1%"
"Kansas",3,212604,174163,11119,397886,38441,"1%"
"Kansas",4,110922,197433,0,308355,-86511,"1%"
"Kentucky",1,82238,246245,15,328498,-164007,"13%"
"Kentucky",2,94638,255728,10022,360388,-161090,"8%"
"Kentucky",3,230603,137396,0,367999,93207,"11%"
"Kentucky",4,125881,256599,0,382480,-130718,"5%"
"Kentucky",5,47798,250652,20,298470,-202854,"11%"
"Kentucky",6,154973,216927,6492,378392,-61954,"5%"
"Louisiana",1,94730,270330,9309,374369,-175600,"5%"
"Louisiana",2,33684,15565,18522,316982,18119,"14%"
"Louisiana",3,39423,230480,9365,340120,-191057,"11%"
"Louisiana",4,23813,19343,0,306578,4470,"15%"
"Louisiana",5,7136,9834,0,309556,-2698,"15%"
"Louisiana",6,95541,265706,12749,373996,-170165,"6%"
"Massachusetts",1,245809,0,9713,255522,245809,"25%"
"Massachusetts",2,247232,124460,538,372230,122772,"6%"
"Massachusetts",3,245840,0,7462,253302,245840,"27%"
"Massachusetts",4,214977,147243,1690,363910,67734,"15%"
"Massachusetts",5,275104,96783,1783,373670,178321,"11%"
"Massachusetts",6,265686,138614,674,404974,127072,"8%"
"Massachusetts",7,128137,0,22067,150204,128137,"50%"
"Massachusetts",8,218293,0,57088,275381,218293,"28%"
"Massachusetts",9,256158,152416,10535,419109,103742,"5%"
"Maryland",1,142981,250099,0,393080,-107118,"4%"
"Maryland",2,214496,103220,0,317716,111276,"10%"
"Maryland",3,252907,109998,0,362905,142909,"6%"
"Maryland",4,274107,71011,0,345118,203096,"5%"
"Maryland",5,269973,122936,0,392909,147037,"4%"
"Maryland",6,200619,139363,6400,346382,61256,"8%"
"Maryland",7,231862,90562,74,322498,141300,"10%"
"Maryland",8,253546,122452,0,375998,131094,"8%"
"Maine",1,211905,139529,800,352234,72376,"22%"
"Maine",2,174455,150084,1331,325870,24371,"20%"
"Michigan",1,154651,256509,6312,417472,-101858,"3%"
"Michigan",2,153566,237872,10372,401810,-84306,"1%"
"Michigan",3,189093,213477,0,402570,-24384,"3%"
"Michigan",4,120836,243373,9843,374052,-122537,"4%"
"Michigan",5,197840,151397,13693,362930,46443,"6%"
"Michigan",6,152100,211495,14838,378433,-59395,"4%"
"Michigan",7,159752,227518,0,387270,-67766,"4%"
"Michigan",8,217929,202519,7896,428344,15410,"2%"
"Michigan",9,231829,153677,15579,401085,78152,"5%"
"Michigan",10,138286,271812,0,410098,-133526,"3%"
"Michigan",11,226076,215362,8934,450372,10714,"3%"
"Michigan",12,254991,117730,11147,383868,137261,"4%"
"Michigan",13,220307,53169,9269,282745,167138,"10%"
"Michigan",14,264205,62486,8105,334796,201719,"11%"
"Minnesota",1,167877,179150,21441,368468,-11273,"8%"
"Minnesota",2,203980,194414,24676,423070,9566,"4%"
"Minnesota",3,243984,194596,0,438580,49388,"4%"
"Minnesota",4,243289,111641,29327,384257,131648,"8%"
"Minnesota",5,255920,102878,37978,396776,153042,"7%"
"Minnesota",6,142469,271153,0,413622,-128684,"3%"
"Minnesota",7,141150,187483,23425,352058,-46333,"11%"
"Minnesota",8,147581,223363,22114,393058,-75782,"7%"
"Missouri",1,245520,59156,6681,311357,186364,"12%"
"Missouri",2,201520,230617,11625,443762,-29097,"5%"
"Missouri",3,116109,282424,8328,406861,-166315,"2%"
"Missouri",4,107528,245064,9934,362526,-137536,"3%"
"Missouri",5,204631,135396,9211,349238,69235,"3%"
"Missouri",6,120753,258904,8152,387809,-138151,"1%"
"Missouri",7,96501,251937,15401,363839,-155436,"1%"
"Missouri",8,70504,253646,5846,329996,-183142,"6%"
"Mississippi",1,101523,224866,280,326669,-123343,"4%"
"Mississippi",2,169087,93659,215,262961,75428,"18%"
"Mississippi",3,114816,213657,0,328473,-98841,"8%"
"Mississippi",4,0,255960,8670,264630,-255960,"7%"
"Montana",1,263335,335214,0,598549,-71879,"1%"
"North Carolina",1,187367,158735,0,346102,28632,"22%"
"North Carolina",2,310979,172019,10827,493825,138960,"1%"
"North Carolina",3,131132,227623,0,358755,-96491,"13%"
"North Carolina",4,332424,161301,0,493725,171123,"4%"
"North Carolina",5,119845,257842,7555,385242,-137997,"1%"
"North Carolina",6,253530,153597,0,407127,99933,"1%"
"North Carolina",7,179053,272448,0,451501,-93395,"1%"
"North Carolina",8,177781,202774,0,380555,-24993,"1%"
"North Carolina",9,178508,223022,0,401530,-44514,"1%"
"North Carolina",10,128146,284019,0,412165,-155873,"1%"
"North Carolina",11,190609,245350,14185,450144,-54741,"1%"
"North Carolina",12,341457,0,0,341457,341457,"1%"
"North Carolina",13,124684,267181,0,391865,-142497,"1%"
"North Dakota",1,98146,245327,12202,355675,-147181,"10%"
"Nebraska",1,119263,188071,8866,316200,-68808,"1%"
"Nebraska",2,153623,169134,9970,332727,-15511,"1%"
"Nebraska",3,50678,225026,10919,286623,-174348,"4%"
"New Hampshire",1,205606,185159,9830,400595,20447,"7%"
"New Hampshire",2,208284,168873,9172,386329,39411,"7%"
"New Jersey",1,224434,135330,0,359764,89104,"4%"
"New Jersey",2,157131,177488,6014,340633,-20357,"9%"
"New Jersey",3,217184,185072,5142,407398,32112,"4%"
"New Jersey",4,156276,243347,7434,407057,-87071,"1%"
"New Jersey",5,211627,181455,4725,397807,30172,"4%"
"New Jersey",6,184141,117369,0,301510,66772,"9%"
"New Jersey",7,212003,207411,0,419414,4592,"3%"
"New Jersey",8,134952,39658,2267,176877,95294,"32%"
"New Jersey",9,178821,85347,6111,270279,93474,"14%"
"New Jersey",10,204240,32400,6495,243135,171840,"22%"
"New Jersey",11,226331,197986,0,424317,28345,"4%"
"New Jersey",12,212725,105094,5471,323290,107631,"10%"
"New Mexico",1,185336,133789,0,319125,51547,"3%"
"New Mexico",2,120766,141227,145,262138,-20461,"3%"
"New Mexico",3,174452,126711,0,301163,47741,"6%"
"Nevada",1,137868,74490,10855,223213,63378,"9%"
"Nevada",2,155780,216078,10815,382673,-60298,"6%"
"Nevada",3,203421,190975,22856,417252,12446,"1%"
"Nevada",4,168457,152284,11728,332469,16173,"3%"
"New York",1,111203,176323,65,287591,-65120,"23%"
"New York",2,116227,159304,2683,278214,-43077,"20%"
"New York",3,148600,142219,1694,292513,6381,"23%"
"New York",4,158411,136928,2285,297624,21483,"20%"
"New York",5,182481,0,82,182563,182481,"32%"
"New York",6,106131,63324,0,169455,42807,"26%"
"New York",7,142815,27907,1158,171880,114908,"24%"
"New York",8,175140,36873,0,212013,138267,"25%"
"New York",9,170898,36847,1947,209692,134051,"25%"
"New York",10,120273,52842,2156,175271,67431,"39%"
"New York",11,99224,136382,0,235606,-37158,"15%"
"New York",12,153815,37973,2732,194520,115842,"42%"
"New York",13,179589,16787,2747,199123,162802,"28%"
"New York",14,105455,46877,1042,153374,58578,"29%"
"New York",15,136471,18198,0,154669,118273,"26%"
"New York",16,161730,0,33608,195338,161730,"37%"
"New York",17,136185,100237,15232,251654,35948,"28%"
"New York",18,138923,128882,2505,270310,10041,"21%"
"New York",19,151493,137229,7466,296188,14264,"17%"
"New York",20,162189,124349,96,286634,37840,"20%"
"New York",21,92621,166561,11,259193,-73940,"17%"
"New York",22,118725,142414,5765,266904,-23689,"17%"
"New York",23,100201,166525,3124,269850,-66324,"16%"
"New York",24,119475,178971,11352,309798,-59496,"10%"
"New York",25,133500,113557,3982,251039,19943,"31%"
"New York",26,170259,82301,3542,256102,87958,"24%"
"New York",27,111174,206671,4176,322021,-95497,"16%"
"Ohio",1,166061,193637,13099,372797,-27576,"10%"
"Ohio",2,140000,217405,87,357492,-77405,"12%"
"Ohio",3,217332,90474,0,307806,126858,"14%"
"Ohio",4,99663,231284,9436,340383,-131621,"8%"
"Ohio",5,118245,251713,0,369958,-133468,"10%"
"Ohio",6,84237,243540,0,327777,-159303,"10%"
"Ohio",7,100027,231246,11205,342478,-131219,"9%"
"Ohio",8,108244,241503,54,349801,-133259,"11%"
"Ohio",9,184367,108085,37,292489,76282,"15%"
"Ohio",10,147985,208347,0,356332,-60362,"11%"
"Ohio",11,233126,58139,0,291265,174987,"21%"
"Ohio",12,178432,236181,12495,427108,-57749,"4%"
"Ohio",13,169487,145275,8206,322968,24212,"12%"
"Ohio",14,155515,233828,0,389343,-78313,"8%"
"Ohio",15,136286,236473,55,372814,-100187,"8%"
"Ohio",16,147198,242523,0,389721,-95325,"7%"
"Oklahoma",1,109641,213700,12130,335471,-104059,"1%"
"Oklahoma",2,63472,216511,8544,288527,-153039,"1%"
"Oklahoma",3,66501,242677,0,309178,-176176,"1%"
"Oklahoma",4,90459,213096,10803,314358,-122637,"1%"
"Oklahoma",5,145658,158191,0,303849,-12533,"1%"
"Oregon",1,296235,161356,0,457591,134879,"1%"
"Oregon",2,166588,271044,13778,451410,-104456,"1%"
"Oregon",3,342906,110321,15672,468899,232585,"1%"
"Oregon",4,239837,214661,10003,464501,25176,"1%"
"Oregon",5,233832,203503,12518,449853,30329,"1%"
"Pennsylvania",1,190830,248357,0,439187,-57527,"3%"
"Pennsylvania",2,193109,73825,0,266934,119284,"19%"
"Pennsylvania",3,333457,33189,0,366646,300268,"16%"
"Pennsylvania",4,263378,179164,0,442542,84214,"1%"
"Pennsylvania",5,253926,139309,0,393235,114617,"8%"
"Pennsylvania",6,223336,174978,0,398314,48358,"3%"
"Pennsylvania",7,193060,179512,0,372572,13548,"3%"
"Pennsylvania",8,178082,166056,0,344138,12026,"5%"
"Pennsylvania",9,116372,229770,0,346142,-113398,"5%"
"Pennsylvania",10,182821,208816,0,391637,-25995,"3%"
"Pennsylvania",11,141290,241855,0,383145,-100565,"1%"
"Pennsylvania",12,98972,240689,0,339661,-141717,"5%"
"Pennsylvania",13,96302,266768,0,363070,-170466,"2%"
"Pennsylvania",14,129721,238361,0,368082,-108640,"5%"
"Pennsylvania",15,91947,254587,0,346534,-162640,"3%"
"Pennsylvania",16,143349,209151,0,352500,-65802,"6%"
"Pennsylvania",17,221112,211256,0,432368,9856,"3%"
"Pennsylvania",18,264921,117858,0,382779,147063,"9%"
"Rhode Island",1,157854,0,63707,221561,157854,"8%"
"Rhode Island",2,153607,109855,0,263462,43752,"2%"
"South Carolina",1,210627,216042,0,426669,-5415,"1%"
"South Carolina",2,155118,202715,6163,363996,-47597,"1%"
"South Carolina",3,95712,237544,0,333256,-141832,"1%"
"South Carolina",4,133023,222126,5090,360239,-89103,"1%"
"South Carolina",5,145979,220006,0,365985,-74027,"1%"
"South Carolina",6,197477,89258,2646,289381,108219,"1%"
"South Carolina",7,138863,224993,0,363856,-86130,"1%"
"South Dakota",1,0,321984,75748,397732,-321984,"1%"
"Tennessee",1,68211,227838,8602,304651,-159627,"1%"
"Tennessee",2,109298,238447,4574,352319,-129149,"1%"
"Tennessee",3,97510,215318,7022,319850,-117808,"1%"
"Tennessee",4,111238,223200,0,334438,-111962,"1%"
"Tennessee",5,250001,0,0,250001,250001,"10%"
"Tennessee",6,83694,257219,8139,349052,-173525,"1%"
"Tennessee",7,95743,244623,9586,349952,-148880,"1%"
"Tennessee",8,97561,226949,6741,331251,-129388,"4%"
"Tennessee",9,187258,48688,6136,242082,138570,"6%"
"Texas",1,82359,218385,0,300744,-136026,"11%"
"Texas",2,148727,197300,5582,351609,-48573,"3%"
"Texas",3,179458,230512,8621,418591,-51054,"1%"
"Texas",4,77343,255157,7637,340137,-177814,"6%"
"Texas",5,100495,173308,5819,279622,-72813,"7%"
"Texas",6,149480,179428,10950,339858,-29948,"6%"
"Texas",7,159529,149054,5542,314125,10475,"7%"
"Texas",8,97283,277124,7725,382132,-179841,"1%"
"Texas",9,172060,49250,6575,227885,122810,"8%"
"Texas",10,187566,216927,8982,413475,-29361,"1%"
"Texas",11,53213,231842,5786,290841,-178629,"8%"
"Texas",12,121053,233366,11905,366324,-112313,"1%"
"Texas",13,47617,220112,5588,273317,-172495,"11%"
"Texas",14,117862,189691,0,307553,-71829,"10%"
"Texas",15,115073,108503,4256,227832,6570,"3%"
"Texas",16,145766,80762,0,226528,65004,"9%"
"Texas",17,125317,171115,9900,306332,-45798,"6%"
"Texas",18,180952,58033,7910,246895,122919,"7%"
"Texas",19,60200,197509,6226,263935,-137309,"11%"
"Texas",20,172648,88171,5900,266719,84477,"5%"
"Texas",21,203858,234026,8585,446469,-30168,"5%"
"Texas",22,181418,209842,15756,407016,-28424,"1%"
"Texas",23,135415,147502,8247,291164,-12087,"1%"
"Texas",24,163326,167910,12785,344021,-4584,"5%"
"Texas",25,165338,219615,7712,392665,-54277,"4%"
"Texas",26,161009,261963,9243,432215,-100954,"1%"
"Texas",27,95117,171834,5460,272411,-76717,"10%"
"Texas",28,136510,91190,6338,234038,45320,"4%"
"Texas",29,111305,42840,2328,156473,68465,"10%"
"Texas",30,204928,48685,10851,264464,156243,"7%"
"Texas",31,174394,210768,9141,394303,-36374,"1%"
"Texas",32,178542,157867,7278,343687,20675,"6%"
"Texas",33,105317,39638,12651,157606,65679,"6%"
"Texas",34,110907,83848,5443,200198,27059,"10%"
"Texas",35,175033,80153,12516,267702,94880,"1%"
"Texas",36,73308,222392,6408,302108,-149084,"8%"
"Utah",1,102874,234657,42,337573,-131783,"1%"
"Utah",2,129195,207066,15268,351529,-77871,"1%"
"Utah",3,94055,239567,15365,348987,-145512,"1%"
"Utah",4,174714,176660,20749,372123,-1946,"1%"
"Virginia",1,186927,260706,0,447633,-73779,"3%"
"Virginia",2,184991,164419,9144,358554,20572,"6%"
"Virginia",3,233326,107299,0,340625,126027,"10%"
"Virginia",4,242721,152600,0,395321,90121,"7%"
"Virginia",5,190340,211012,0,401352,-20672,"8%"
"Virginia",6,135022,246427,0,381449,-111405,"2%"
"Virginia",7,232995,224679,0,457674,8316,"2%"
"Virginia",8,301454,95365,0,396819,206089,"8%"
"Virginia",9,0,271851,0,271851,-271851,"14%"
"Virginia",10,268654,206336,0,474990,62318,"1%"
"Virginia",11,280733,111380,0,392113,169353,"6%"
"Vermont",1,238835,95832,20311,354978,143003,"1%"
"Washington",1,248393,174926,0,423319,73467,"1%"
"Washington",2,253183,146730,0,399913,106453,"1%"
"Washington",3,180850,234828,0,415678,-53978,"1%"
"Washington",4,101621,200611,0,302232,-98990,"1%"
"Washington",5,153579,243427,0,397006,-89848,"1%"
"Washington",6,246556,168018,0,414574,78538,"1%"
"Washington",7,386321,77928,0,464249,308393,"2%"
"Washington",8,211859,197192,40,409091,14667,"1%"
"Washington",9,258183,89334,0,347517,168849,"1%"
"Washington",10,110892,0,26314,288127,110892,"15%"
"Wisconsin",1,144735,226253,0,370988,-81518,"14%"
"Wisconsin",2,318520,138305,0,456825,180215,"1%"
"Wisconsin",3,199883,189617,0,389500,10266,"1%"
"Wisconsin",4,232654,70768,7911,311333,161886,"17%"
"Wisconsin",5,179162,266515,0,445677,-87353,"1%"
"Wisconsin",6,164239,238874,220,403333,-74635,"1%"
"Wisconsin",7,162758,252044,0,414802,-89286,"1%"
"Wisconsin",8,127495,243781,0,371276,-116286,"1%"
"West Virginia",1,80990,180163,50,261203,-99173,"3%"
"West Virginia",2,100799,172195,0,272994,-71396,"1%"
"West Virginia",3,64769,161390,44,226203,-96621,"6%"
"Wyoming",1,66576,185732,18059,270367,-119156,"1%"
